1 13 31
###############################
#p    1**      *   *  * * *   #
# # # #*# # #*#*# # # #*#*#*# #
#b  *     *    *      *   * * #
#b# # # # #*# # #*#*# # # # #*#
#f         x **  *  *         #
#b# # # # # # # # # # #*# # # #
#*  *      *  *      *        #
#b# # # #*# # # # #*# # # # # #
#*    *  *        *           #
#b#*# # # # # # #*# # # # # # #
#           *   *  *          #
###############################